WWWWWWWWWWWWWWWWWWW
W........W........W
WbWW.WWW.W.WWW.WWbW
W.WW.WWW.W.WWW.WW.W
W........s........W
W.WW.W.WWWWW.W.WW.W
W....W...W...W....W
WWWW.WWW.W.WWW.WWWW
WWWW.W       W.WWWW
WWWW.W WWgWW W.WWWW
    .  WvvvW  .
WWWW.W WWWWW W.WWWW
WWWW.W       W.WWWW
WWWW.W WWWWW W.WWWW
W........W........W
W.WW.WWW.W.WWW.WW.W
Wb.W.....s.....W.bW
WW.W.W.WWWWW.W.W.WW
W....W...W...W....W
W.WWWWWW.W.WWWWWW.W
W.................W
WWWWWWWWWWWWWWWWWWW